27 20
0:2 1:3 2:4 3:5 4:6 5:wall_BR 6:wall_B 7:wall_ER l:wall_TL r:wall_TR 8:wall_EL
0:0 2:1 0:0 0:0 0:0 0:0 0:0 0:0 0:0 0:0 0:0 2:1 2:1 2:1 2:1 2:1 2:1 2:1 1:1 0:0
0:0 1:1 0:0 0:0 0:0 0:0 0:0 0:0 0:0 0:0 0:0 2:1 2:1 2:1 2:1 2:1 2:1 1:1 0:0 0:0
0:0 0:0 0:0 0:0 0:0 0:0 3:1 3:1 0:0 0:0 0:0 2:1 2:1 2:1 1:1 2:1 2:1 0:0 0:0 0:0
0:0 0:0 0:0 0:0 0:0 0:0 2:1 2:1 0:0 0:0 0:0 2:1 2:1 2:1 0:0 2:1 2:1 0:0 0:0 0:0
3:1 3:1 3:1 3:1 0:0 0:0 1:1 1:1 0:0 0:0 0:0 1:1 2:1 2:1 3:1 2:1 2:1 3:1 0:0 0:0
2:1 2:1 1:1 1:1 0:0 0:0 0:0 0:0 0:0 0:0 0:0 0:0 2:1 2:1 2:1 2:1 2:1 2:1 0:0 0:0
1:1 1:1 0:0 0:0 3:1 3:1 0:0 0:0 0:0 0:0 0:0 0:0 1:1 2:1 2:1 2:1 2:1 2:1 3:1 0:0
0:0 0:0 0:0 3:1 2:1 2:1 3:1 3:1 3:1 0:0 0:0 0:0 0:0 1:1 2:1 2:1 2:1 1:1 2:1 3:1
0:0 0:0 3:1 2:1 2:1 2:1 2:1 2:1 1:1 0:0 0:0 0:0 0:0 0:0 2:1 2:1 2:1 0:0 1:1 2:1
0:0 0:0 2:1 2:1 2:1 2:1 1:1 1:1 0:0 0:0 0:0 0:0 0:0 0:0 1:1 2:1 1:1 0:0 0:0 1:1
0:0 0:0 2:1 2:1 2:1 1:1 0:0 0:0 l:9 6:9 6:9 6:9 r:9 0:0 0:0 1:1 0:0 0:0 0:0 0:0
0:0 0:0 2:1 2:1 1:1 0:0 0:0 0:0 8:9 0:0 0:0 0:0 7:9 0:0 0:0 0:0 0:0 0:0 0:0 0:0
0:0 0:0 2:1 1:1 0:0 0:0 0:0 0:0 8:9 0:0 0:0 0:0 7:9 0:0 0:0 0:0 0:0 0:0 0:0 0:0
0:0 0:0 1:1 0:0 0:0 0:0 0:0 0:0 8:9 0:0 0:0 0:0 7:9 0:0 0:0 0:0 0:0 0:0 0:0 0:0
0:0 0:0 0:0 0:0 0:0 0:0 0:0 0:0 6:9 6:9 6:9 6:9 5:9 0:0 0:0 0:0 0:0 0:0 0:0 0:0
0:0 0:0 0:0 0:0 0:0 0:0 0:0 0:0 0:0 0:0 0:0 0:0 0:0 0:0 0:0 0:0 0:0 0:0 0:0 0:0
3:1 3:1 3:1 3:1 3:1 0:0 0:0 0:0 0:0 0:0 0:0 0:0 0:0 0:0 0:0 0:0 0:0 0:0 0:0 0:0
2:1 2:1 2:1 2:1 2:1 3:1 0:0 0:0 0:0 0:0 0:0 0:0 0:0 0:0 0:0 0:0 0:0 0:0 0:0 0:0
2:1 2:1 2:1 2:1 2:1 2:1 3:1 0:0 0:0 0:0 0:0 0:0 0:0 0:0 0:0 0:0 0:0 0:0 0:0 0:0
2:1 2:1 2:1 2:1 2:1 2:1 1:1 5:9 0:0 0:0 0:0 0:0 0:0 0:0 0:0 0:0 0:0 0:0 0:0 0:0
2:1 2:1 2:1 2:1 1:1 1:1 5:9 5:9 0:0 0:0 0:0 0:0 0:0 0:0 0:0 0:0 0:0 0:0 0:0 0:0
2:1 2:1 1:1 1:1 5:9 5:9 5:9 4:9 0:0 0:0 0:0 0:0 0:0 0:0 0:0 0:0 0:0 0:0 0:0 0:0
2:1 2:1 6:9 6:9 4:9 4:9 4:9 0:0 0:0 0:0 0:0 0:0 0:0 0:0 0:0 0:0 0:0 0:0 0:0 0:0
2:1 2:1 3:1 3:1 3:1 3:1 0:0 0:0 0:0 0:0 0:0 0:0 0:0 0:0 0:0 0:0 0:0 0:0 0:0 0:0
2:1 2:1 2:1 2:1 2:1 1:1 0:0 0:0 0:0 0:0 0:0 0:0 0:0 0:0 0:0 0:0 0:0 0:0 0:0 0:0
1:1 2:1 2:1 2:1 2:1 0:0 0:0 0:0 0:0 0:0 0:0 0:0 0:0 0:0 0:0 0:0 0:0 0:0 0:0 0:0
0:0 1:1 2:1 2:1 2:1 0:0 0:0 0:0 0:0 0:0 0:0 0:0 0:0 0:0 0:0 0:0 0:0 0:0 0:0 0:0
