27 20
0:2 1:3 2:4 3:5 4:6 5:7 6:8
0:0 2:1 0:0 0:0 0:0 0:0 0:0 0:0 0:0 0:0 0:0 2:1 2:1 2:1 2:1 2:1 2:1 2:1 1:1 0:0
0:0 1:1 0:0 0:0 0:0 0:0 0:0 0:0 0:0 0:0 0:0 2:1 2:1 2:1 2:1 2:1 2:1 1:1 0:0 0:0
0:0 0:0 0:0 0:0 0:0 0:0 3:1 3:1 0:0 0:0 0:0 2:1 2:1 2:1 1:1 2:1 2:1 0:0 0:0 0:0
0:0 0:0 0:0 0:0 0:0 0:0 2:1 2:1 0:0 0:0 0:0 2:1 2:1 2:1 0:0 2:1 2:1 0:0 0:0 0:0
3:1 3:1 3:1 3:1 0:0 0:0 1:1 1:1 0:0 0:0 0:0 1:1 2:1 2:1 3:1 2:1 2:1 3:1 0:0 0:0
2:1 2:1 1:1 1:1 0:0 0:0 0:0 0:0 0:0 0:0 0:0 0:0 2:1 2:1 2:1 2:1 2:1 2:1 0:0 0:0
1:1 1:1 0:0 0:0 3:1 3:1 0:0 0:0 0:0 0:0 0:0 0:0 1:1 2:1 2:1 2:1 2:1 2:1 3:1 0:0
0:0 0:0 0:0 3:1 2:1 2:1 3:1 3:1 3:1 0:0 0:0 0:0 0:0 1:1 2:1 2:1 2:1 2:1 2:1 3:1
0:0 0:0 3:1 2:1 2:1 2:1 2:1 2:1 1:1 0:0 0:0 0:0 0:0 0:0 2:1 2:1 2:1 0:0 1:1 2:1
0:0 0:0 2:1 2:1 2:1 2:1 1:1 1:1 0:0 0:0 0:0 0:0 0:0 0:0 1:1 2:1 2:1 0:0 0:0 1:1
0:0 0:0 2:1 2:1 2:1 1:1 0:0 0:0 0:0 0:0 0:0 0:0 0:0 0:0 0:0 1:1 0:0 0:0 0:0 0:0
0:0 0:0 2:1 2:1 1:1 0:0 0:0 0:0 0:0 0:0 0:0 0:0 0:0 0:0 0:0 0:0 0:0 0:0 0:0 0:0
0:0 0:0 2:1 1:1 0:0 0:0 0:0 0:0 0:0 0:0 0:0 0:0 0:0 0:0 0:0 0:0 0:0 0:0 0:0 0:0
0:0 0:0 1:1 0:0 0:0 0:0 0:0 0:0 0:0 0:0 0:0 0:0 0:0 0:0 0:0 0:0 0:0 0:0 0:0 0:0
0:0 0:0 0:0 0:0 0:0 0:0 0:0 0:0 0:0 0:0 0:0 0:0 0:0 0:0 0:0 0:0 0:0 0:0 0:0 0:0
0:0 0:0 0:0 0:0 0:0 0:0 0:0 0:0 0:0 0:0 0:0 0:0 0:0 0:0 0:0 0:0 0:0 0:0 0:0 0:0
3:1 3:1 3:1 3:1 3:1 0:0 0:0 0:0 0:0 0:0 0:0 0:0 0:0 0:0 0:0 0:0 0:0 0:0 0:0 0:0
2:1 2:1 2:1 2:1 2:1 3:1 0:0 0:0 0:0 0:0 0:0 0:0 0:0 0:0 0:0 0:0 0:0 0:0 0:0 0:0
2:1 2:1 2:1 2:1 2:1 2:1 3:1 0:0 0:0 0:0 0:0 0:0 0:0 0:0 0:0 0:0 0:0 0:0 0:0 0:0
2:1 2:1 2:1 2:1 2:1 2:1 2:1 5:9 0:0 0:0 0:0 0:0 0:0 0:0 0:0 0:0 0:0 0:0 0:0 0:0
2:1 2:1 2:1 2:1 2:1 2:1 5:9 5:9 0:0 0:0 0:0 0:0 0:0 0:0 0:0 0:0 0:0 0:0 0:0 0:0
2:1 2:1 2:1 2:1 5:9 5:9 5:9 4:9 0:0 0:0 0:0 0:0 0:0 0:0 0:0 0:0 0:0 0:0 0:0 0:0
2:1 2:1 6:9 6:9 4:9 4:9 4:9 0:0 0:0 0:0 0:0 0:0 0:0 0:0 0:0 0:0 0:0 0:0 0:0 0:0
2:1 2:1 3:1 3:1 3:1 3:1 0:0 0:0 0:0 0:0 0:0 0:0 0:0 0:0 0:0 0:0 0:0 0:0 0:0 0:0
2:1 2:1 2:1 2:1 2:1 1:1 0:0 0:0 0:0 0:0 0:0 0:0 0:0 0:0 0:0 0:0 0:0 0:0 0:0 0:0
1:1 2:1 2:1 2:1 2:1 0:0 0:0 0:0 0:0 0:0 0:0 0:0 0:0 0:0 0:0 0:0 0:0 0:0 0:0 0:0
0:0 1:1 2:1 2:1 2:1 0:0 0:0 0:0 0:0 0:0 0:0 0:0 0:0 0:0 0:0 0:0 0:0 0:0 0:0 0:0
